1111111111111
1001000M000C1
1000011111001
1P0001E000001
100C0100M0001
1000010000001
1100000000C01
10C00000M0001
1111110001001
100M000010001
10C000C100001
10010001000C1
1111111111111
