111111111111111111111111111111111111111
10010000000C0000010000000001000M00000C1
100001111100000011100000001110011111001
1P0001000000000111110000000100011111001
100C01000000000011100000C00000011111001
100001000000000001000000M00000011111001
10000000000000000M000000000000000000001
10C000000M00000001000000000000000001101
111111000000000011100000001000000010001
1000000010000001111100000010000000100C1
100000C10000001111111000000100000010001
10100001000C000000000000001000000001101
101000000001000001000000000000000000001
101000000M00100010000000000000001000101
101000000000010100000000000000000101001
10100000000000100M000000000000000010001
101000000000010100000000000000000101001
101000000000100010000000000000001000101
1C1000000M010000010000000000000000000E1
111111111111111111111111111111111111111
