1111111111111111111111111111111111111111
1P000M00000100000C1000000000CCCCCCCCCCC1
1000001100001001110000000000C0000M0000C1
10000C11000000000M0000000000CCCCCCCCCCE1
1111111111111111111111111111111111111111
