1111111111111111111111111111111111111111
1P000000000100000C10000000000CCCCCCCCCC1
10000011000010011100000000000CCCCCCCCCC1
10000C11000000000000000000000CCCCCCCCCE1
1111111111111111111111111111111111111111
