1111111111111
10010000000C1
1000011111001
1P0001E000001
100C010000001
1000010000001
1100000000C01
10C0000000001
1111110001001
1000000010001
10C000C100001
10010001000C1
1111111111111
