111111111111111111111111111111111111111
10010000000C000000000000000100000000001
100001111100000010000000001110001100001
1P0001E00000000111000000000100001100001
100C01000000001111100000C00000000000001
100001000000000111000000000000000000001
1100000000C0000010000010000000000011111
10C000000000000000000000000000000100001
111111000100101011111000001000001001101
100000001000000001111000001000001010001
10C000C10000000001111000000101111010111
10010001000C0000000000000010000000100C1
111111111111111111111111111111111111111
